The Deepling Language, Volume II: Exercises
By Lagatos, Chronicler and Scholar
Exercises, Chapter II: Basic Vocabulary 2 (F-W)
face=thn
from/of the=ho
greet/greeting=lhnjei
guide=neta
hand=roff
him/he=ku
in=um
intruder=kenh
let=jul
library=giotja
light=fie
march=shum
narrow=dakn
not=ro
obey=qohn
over/up/on=gou
path=kweh
peace=dividej
perseverance/endurance=lorkulh
protect=jau
reach=lume
rise=cie
sea/water=jhli
seabed=jhlimeh
seven=laek
shall=to
sit/sitting=toky
smile/smiling=solesteh
statue/figure=bost
surface=gouthn
visit/visitor=buhel
walk=motom
watch=afar
what=gonn
when/if=el
who=hon
will=krum